单	四
一	亖
且	𠁠
丶	灬
乂	㸚
人	𠈌
先	𠓙
匕	𣬅
厶	𠫬
又	叕
口	㗊
囚	𡈶
困	𡈹
土	㙓
天	𡚌
小	𡮐
屮	茻
工	㠭
日	𣊫
春	𣌠
曰	𣊭
月	朤
朿	𣡍
林	𣡽
果	𣡾
水	㵘
泉	𤆁
火	燚
牛	𤛭
田	𤳳
甲	𤳵
石	𥗉
竹	𥷹
老	𦓋
興	𠔻
言	𧮦
車	𨏿
金	𨰻
門	𨷾
雲	𩇔
雷	䨻
風	𩙡
魚	䲜
龍	𪚥
木	𣛧
