单	双
ㄑ	巜
一	二
卄	卌
串	丳
乂	爻
尹	𡱉
𠂢	𠃄
乙	𠃐
九	𠃙
习	羽
𠄌	𠃏
予	㐨
二	亖
井	㐩
亦	𠅯
享	㝇
人	仌
人	从
來	𠐇
來	㯤
倉	𠑐
僉	𠑲
兀	𠀘
兄	㒭
先	兟
入	𠓜
几	𠘬
凡	𠘻
力	𠠴
匕	比
區	𠥺
卅	𢌽
卪	𠨖
㔾	𠨎
厶	厸
厶	㕕
又	双
又	㕛
口	吅
口	吕
古	𠳬
句	𠣪
号	𠳯
𠮢	𠭎
吉	喆
启	𢩙
呆	槑
善	𡆃
喜	囍
土	圭
堯	㚁
夕	多
夕	𡖇
大	夶
太	𡘋
夫	㚘
奇	㚡
女	奻
子	孖
尸	𡰲
屮	艸
山	屾
山	岀
巢	𢀌
左	𢀡
巾	𢁝
巿	𢂏
干	幵
幺	𢆶
廿	𠦜
弓	弜
𢎘	𢎙
彐	𢑑
㣇	㣈
心	𢗰
戈	戋
户	𢨯
户	𢨳
手	抙
支	𢺸
斤	斦
旡	兓
日	昌
日	昍
明	𣊧
易	𣊷
昔	𣊣
月	朋
木	林
朿	棗
朿	棘
東	㯥
果	𣛕
桼	𣠬
欠	𣢐
歹	㱛
母	𣫯
毛	㲎
水	沝
永	𣴏
火	炎
火	炏
片	㸞
牙	𤘆
牛	牪
牟	𤚅
犬	㹜
玄	玆
王	玨
瓜	㼌
生	甡
田	畕
男	𤲶
畐	㽬
白	㿟
百	皕
目	䀠
真	㒹
石	砳
示	祘
禺	𥝉
禾	秝
秉	𥡝
立	竝
竞	競
老	䎜
耳	聑
臣	𦣦
至	臸
舌	𦧚
虎	虤
虫	䖵
見	覞
言	誩
豕	豩
貝	賏
走	𧼂
足	踀
車	䡛
辛	辡
邑	䣈
金	鍂
隹	雔
隻	䨇
面	𩈲
面	𩈳
音	䪭
竟	竸
風	䬕
飞	𠃧
香	𩡌
香	𩡐
馬	騳
魚	䲆
魚	𩺰
齒	𪙹
龍	龖
