单	三
ㄑ	巛
一	三
七	㐂
个	𠁭
丿	彡
了	𠄕
人	众
人	㐺
介	𠌕
兔	𠓗
全	𠓾
刀	刕
力	劦
十	𠦄
㔾	𠨕
原	厵
厶	厽
去	𠬑
又	叒
口	品
口	𠱠
吉	嚞
土	垚
士	壵
夏	𡖃
大	𡘙
天	𡙎
太	𡙒
女	姦
妥	𤕇
子	孨
子	𡥦
宜	𡬐
客	𡬚
寒	𡬜
小	尛
屮	芔
山	𡷈
巛	𡿭
市	𢅈
弓	𢏝
心	惢
户	𢩕
手	掱
文	𣁕
日	晶
日	晿
木	森
木	𣓏
朿	𣝯
林	𣡕
果	𣡗
欠	𣣓
止	歮
毛	毳
水	淼
水	㴇
泉	灥
火	焱
火	㷋
牛	犇
犬	猋
瓜	𤬑
生	㽓
田	畾
甲	𤳅
白	皛
盖	𥃣
目	瞐
直	矗
眉	𡳻
石	磊
秦	䆐
空	𥩌
竹	𥴒
羊	羴
羗	𦏱
老	𦓈
耳	聶
興	𦧅
舌	舙
舍	𠑰
若	䖃
虫	蟲
虫	𧔗
言	譶
贝	贔
車	轟
金	鑫
门	𨷮
隹	雥
隹	雦
雲	䨺
雷	靐
面	𩉖
頁	𩖏
風	飍
飞	飝
香	馫
馬	驫
马	𩧢
魚	鱻
鹿	麤
龍	龘
